/ Gerado e adaptado daqui: https://www.dcode.fr/maze-generator
21 21
#####################
#     #   # #       #
### ### ### ### ### #
#     # #   #     # #
##### # ### ### #####
#N    #   # #     # #
### ### ### ### # # #
#     #       # # # #
### ### # # # # ### #
#   #   # # #       #
### ### ### ### ### #
# # # #  N# #     # #
# # # # ##### ##### #
# #     #   # # # # #
# #####K# ### # # # #
#           #     # #
# # ### # # # ##### #
# # #   # # # #   # #
# # ######### ### # #
#S#         #   #  E#
#####################